 
 
  4  4  24     4  4  4  4  4     4  4  4  4  2
  21  1 1  2   2             0   0           0
  21  1 1  2   2             0   0           0 
  21  1 1  2   2             0   0           0
  21  1 1  2   2             0   0           0
  21  1 1  2   2             0   0           0
  21  1 1  2   2             0   0           0
  4  4  24     4  4  4  4  4     4  4  4  4  2
